111111111111111
100000000000001
1000P000C00C001
1000000E0000001
111111111111111