11111111111111111111111111111111111
10000000000000C00000C00000000000011
10100101001000010100100000001010011
10100100101101000100100000001E11111
1P0000000C0C0000000000000000000C111
11111111111111111111111111111111111